.,.,.,.,.,.,.,.,.,.,.,.,.,.,.,.,.,.,.,.,.,.,.,.,.,.,.,.,.,.,.,.,.,.,.,.,.,.,.,.,.,.,.,.,.,.,.,.,.,.
.,.,.,.,.,.,.,.,.,.,.,.,.,.,.,.,.,.,.,.,.,.,.,.,.,.,.,.,.,.,.,.,.,.,.,.,.,.,.,.,.,.,.,.,.,.,.,.,.,.
.,.,.,.,.,.,.,.,.,.,.,.,.,.,.,.,.,.,.,.,.,.,.,.,.,.,.,.,.,.,.,.,.,.,.,.,.,.,.,.,.,.,.,.,.,.,.,.,.,.
.,#,#,#,#,#,#,#,#,#,#,#,#,#,#,#,#,#,#,#,#,#,#,#,#,#,#,#,#,#,#,#,#,#,#,#,#,#,#,#,#,v,#,#,#,#,#,#,#,.
.,#,.,.,.,.,.,.,.,.,.,.,.,.,.,.,.,.,.,.,.,.,.,.,.,#,.,.,C,C,C,C,C,C,C,.,.,.,.,.,.,.,.,.,.,p,p,p,#,.
.,#,.,.,.,.,.,.,.,.,.,.,.,.,.,.,.,.,.,.,.,.,.,.,.,#,.,.,C,C,C,C,C,C,C,.,.,.,.,.,.,.,.,.,.,p,p,p,#,.
.,#,.,.,.,.,.,.,.,.,.,.,.,.,.,.,.,.,.,.,.,.,.,.,.,#,.,.,C,C,C,C,C,C,C,.,.,.,.,.,.,.,.,.,.,p,p,p,#,.
.,#,.,.,.,.,.,.,.,.,.,.,.,.,.,.,.,.,.,.,.,.,.,.,.,!,.,.,C,C,C,C,C,C,C,.,.,.,.,.,.,.,.,.,.,.,.,.,#,.
.,>,.,.,.,.,.,.,.,.,.,.,.,.,.,.,.,.,.,.,.,.,.,.,.,!,.,.,C,C,C,C,C,C,C,.,.,.,.,.,.,.,.,.,.,.,.,.,#,.
.,#,.,.,.,.,.,.,.,.,.,.,.,.,.,.,.,.,.,.,.,.,.,.,.,!,.,.,C,C,C,C,C,C,C,.,.,.,.,.,.,.,.,.,.,.,.,.,#,.
.,#,.,.,.,.,.,.,.,.,.,.,.,.,.,.,.,.,.,.,.,.,.,.,.,#,.,.,C,C,C,C,C,C,C,.,.,.,.,.,.,.,.,.,.,.,.,.,#,.
.,#,.,.,.,.,.,.,.,.,.,.,.,.,.,.,.,.,.,.,.,.,.,.,.,#,.,.,C,C,C,C,C,C,C,.,.,.,.,.,.,.,.,.,.,.,.,.,#,.
.,#,.,.,.,.,.,.,.,.,.,.,.,.,.,.,.,.,.,.,.,.,.,.,.,#,.,.,C,C,C,C,C,C,C,.,.,.,.,z,z,z,z,z,.,.,.,.,#,.
.,#,B,B,B,B,B,B,.,.,.,.,.,b,b,b,b,b,b,#,#,#,#,#,#,v,#,#,#,#,#,#,#,#,#,.,.,.,.,#,#,#,#,#,#,#,#,#,#,.
.,#,B,B,B,B,B,B,.,.,.,.,.,b,b,b,b,b,b,#,o,o,o,.,.,.,.,.,x,x,x,x,x,x,#,c,c,c,c,c,c,c,c,c,c,c,c,c,#,.
.,#,B,B,B,B,B,B,.,.,.,.,.,b,b,b,b,b,b,#,o,o,o,.,.,.,.,.,x,x,x,x,x,x,#,c,c,c,c,c,c,c,c,c,c,c,c,c,#,.
.,#,B,B,B,B,B,B,.,.,.,.,.,b,b,b,b,b,b,#,o,o,o,.,.,.,.,.,x,x,x,x,x,x,#,.,.,.,.,.,.,.,.,.,.,.,.,.,#,.
.,#,B,B,B,B,B,B,.,.,.,.,.,b,b,b,b,b,b,#,o,o,o,.,.,.,.,.,x,x,x,x,x,x,#,.,.,.,.,.,.,.,.,.,.,.,.,.,#,.
.,#,B,B,B,B,B,B,.,.,.,.,.,b,b,b,b,b,b,#,.,.,.,.,.,.,.,.,.,.,.,.,.,.,>,.,.,.,.,.,.,.,.,.,.,.,.,.,#,.
.,#,B,B,B,B,B,B,.,.,.,.,.,.,.,.,.,.,.,!,.,.,.,.,.,.,.,.,.,.,.,.,.,.,#,.,.,.,.,.,.,.,.,.,.,.,.,.,#,.
.,#,B,B,B,B,B,B,.,.,.,.,.,.,.,.,.,.,.,!,.,.,.,.,.,.,.,.,.,.,.,.,.,.,<,.,.,.,.,.,.,.,.,.,.,.,.,.,#,.
.,#,B,B,B,B,B,B,.,.,.,.,.,.,.,.,.,.,.,!,.,.,.,.,.,.,.,.,.,.,.,.,.,.,#,.,.,.,.,.,.,.,.,.,.,.,.,.,#,.
.,#,B,B,B,B,B,B,.,.,.,.,.,.,.,.,.,.,.,#,.,.,.,.,.,.,.,.,.,.,.,.,.,.,#,.,.,.,.,.,.,.,.,.,.,.,.,.,#,.
.,#,B,B,B,B,B,B,.,.,.,.,.,.,.,.,.,.,.,#,A,A,A,.,.,.,.,.,a,a,a,a,a,a,#,!,!,!,!,!,!,!,!,!,!,!,!,!,#,.
.,#,B,B,B,B,B,B,.,.,.,.,.,.,.,.,y,y,y,#,A,A,A,.,.,.,.,.,a,a,a,a,a,a,#,D,D,D,D,D,D,D,D,D,D,D,D,D,#,.
.,#,B,B,B,B,B,B,.,.,.,.,.,.,.,.,y,y,y,#,A,A,A,.,.,.,.,.,a,a,a,a,a,a,#,.,.,.,.,.,.,.,.,.,.,.,.,.,#,.
.,#,B,B,B,B,B,B,.,.,.,.,.,.,.,.,y,y,y,#,A,A,A,.,.,.,.,.,a,a,a,a,a,a,#,.,.,.,.,.,.,.,.,.,.,.,.,.,#,.
.,#,B,B,B,B,B,B,.,.,.,.,.,.,.,.,y,y,y,#,A,A,A,.,.,.,.,.,a,a,a,a,a,a,#,.,.,.,.,.,.,.,.,.,.,.,.,.,#,.
.,#,#,#,#,#,#,#,#,#,^,#,#,#,#,#,#,#,#,#,A,A,A,.,.,.,.,.,a,a,a,a,a,a,#,.,.,.,.,.,.,.,.,.,.,.,.,.,#,.
.,#,.,.,.,.,.,.,.,.,.,.,.,.,.,.,.,.,.,!,A,A,A,.,.,.,.,.,a,a,a,a,a,a,#,.,.,.,.,.,.,.,.,.,.,.,.,.,#,.
.,#,.,.,.,.,.,.,.,.,.,.,.,.,.,.,.,.,.,!,A,A,A,.,.,.,.,.,a,a,a,a,a,a,?,.,.,.,.,.,.,.,.,.,.,.,.,.,#,.
.,>,S,.,.,.,.,.,.,.,.,.,.,.,.,.,.,.,.,!,A,A,A,.,.,.,.,.,a,a,a,a,a,a,?,.,.,.,.,.,.,.,.,.,.,.,.,.,<,.
.,#,.,.,.,.,.,.,.,.,.,.,.,.,.,.,.,.,.,!,A,A,A,.,.,.,.,.,a,a,a,a,a,a,?,.,.,.,.,.,.,.,.,.,.,.,.,.,#,.
.,#,.,.,.,.,.,.,.,.,.,.,.,.,.,.,.,.,.,!,A,A,A,.,.,.,.,.,a,a,a,a,a,a,#,.,.,.,.,.,.,.,.,.,.,.,.,.,#,.
.,#,#,#,#,#,#,#,#,#,#,#,#,#,#,#,#,#,#,#,#,#,#,#,#,#,#,#,#,#,#,#,#,#,#,#,#,#,#,#,#,#,#,#,#,#,#,#,#,.
.,.,.,.,.,.,.,.,.,.,.,.,.,.,.,.,.,.,.,.,.,.,.,.,.,.,.,.,.,.,.,.,.,.,.,.,.,.,.,.,.,.,.,.,.,.,.,.,.,.
.,.,.,.,.,.,.,.,.,.,.,.,.,.,.,.,.,.,.,.,.,.,.,.,.,.,.,.,.,.,.,.,.,.,.,.,.,.,.,.,.,.,.,.,.,.,.,.,.,.